NO ./textures/p1.png
SO ./textures/p2.png
WE ./textures/p3.png
EA ./textures/p4.png

F 10,10,30
C 5,5,10

1111111111111111111111111111111111111111111111111111
1111111111111111111111111111111111111111111111111111
1111111111111111111111111111111111111111111111111111
1111111111111111111111111111111111111111111111111111
1111111111111111000000001111111110000011111111111111
1111111111111111011111101111111010000011111111111111
1111111111111111010000101111111010111011111111111111
1111111111111111010110101111111010101011111111111111
1111111111111111010100101110000010101011111111111111
1111111111111111010100101110111010101011111111111111
1111111111111111010100101110100010101011111111111111
1111111111111111010100101110101110101011111111111111
1111111111111111010100100010101010101011111111111111
1111111111111111010100111010101010101011111111111111
1111111111111111010100000010101010101011111111111111
1111111111111111010111111010101010101011111111111111
1111111111111111010000000010101010101011111111111111
1111111111111111011111111010101010101011111111111111
1111111111111111000000011010101010101011111111111111
1111111111111111011111011010101010101011111111111111
1111111111111111010000011010101010101011111111111111
1111111111111111010111111010101010101011111111111111
1111111111111111010100000010101010101011111111111111
1111111111111111010101111010101010101011111111111111
1111111111111111010101000010101010101011111111111111
1111111111111111010101011010101010101011111111111111
1111111111111111010101010010101010101011111111111111
1111111111111111010101011010101010101011111111111111
1111111111111111010101011010101010101011111111111111
1111111111111111010101011010101010101011111111111111
1111111111111111010101011010101010101011111111111111
1111111111111111010101010010101010101011111111111111
1111111111111111010101011010101010101011111111111111
1111111111111111010101011010101010101011111111111111
1111111111111111010100011010101010101011111111111111
1111111111111111010111011010101010101011111111111111
1111111111111111010000011010101010101011111111111111
1111111111111111011111011010101010101011111111111111
1111111111111111000000011000000000100011111111111111
11111111111111110111111110001111000111011111111111111
111111111111111100000000100000000010011111111111111
1111111111111111011111111000001000111011111111111111
11111111111111110100000010111001110010011111111111111
1111111111111111010111111000000000111011111111111111
11111111111111110101000010000100010011111111111111
1111111111111111010101111000001100111011111111111111
1111111111111111010101001000010000010011111111111111
1111111111111111010101011000000000111011111111111111
11111111111111110101010100000S0000000011111111111111
1111111111111111010101011010101010101011111111111111
1111111111111111000000000010000000011111111111111111
1111111111111111111111111111111111111111111111111111
1111111111111111111111111111111111111111111111111111
1111111111111111111111111111111111111111111111111111
1111111111111111111111111111111111111111111111111111
