NO ./textures/north.png
SO ./textures/south.png
WE ./textures/west.png
EA ./textures/east.png
F 220,100,0
C 225,30,0

1111111
1N0  1
1001
1111111