NO ./textures/north.png
SO ./textures/south.png
WE ./textures/west.png
EA ./textures/east.png
F 220,100,0
C 225,30,0

111111111
1N00000S1
100000001
1W00000E1
111111111
