NO ./textures/north.png
SO ./textures/south.png
WE ./textures/west.png
EA ./textures/east.png

F 90,170,90
C 255,190,140

1111111111111111111111111111111111
1111111111000000000110000000000001
1111111111111111111111111111111111
1111111111011000001110000000000001
1111111111001000000000000000000001
1111111110110000011100000000000011
1000000000110000011101111111111111
1111011111111101110000001000111111       
1111011111111101110101001000111111
11000000110101011100N0001000111111
1000000000000000110000001000111111
1000000000000000110101001000111111
1100000111010101111101111000111111
1111011111110101111101111010001111
1111111111111111111111111111111111

